border_size=1
usage=map

Wo          , Wo          , Wo          , Wo          , Ww          , Ww^Bw\      , Ds          , Ds          , Ds          , Ds          , Gg          , Gg          , Re          , Hh          , Mm          , Mm          , Mm          , Mm          , Mm          , Mm          , Mm          , Hh          
Wo          , Wo          , Wo          , Ww          , Ww^Bw\      , Ds          , Ds          , Ds          , Ds          , Ds          , Ds          , Gg          , Re          , Gg          , Hh          , Hh          , Mm          , Mm^Vhh      , Ww          , Ww          , Mm          , Hh          
Wo          , Wo          , Ww          , Ww          , Ds          , Ds          , Ds          , Gs^Fp       , Gs^Fp       , Gs^Fp       , Ds          , Gg          , Re          , Gg          , Gg          , Gg          , Hh          , Ww          , Ww          , Ww          , Ww          , Hh          
Wo          , Wo          , Ww          , Ds          , Ds          , Ds          , Gg          , Gg          , Gg          , Gs^Fp       , Gs^Fp       , Ds          , Re          , Gg          , Gg          , Gg          , Ww          , Ww          , Ww          , Ww          , Ww          , Ww          
Wo          , Wo          , Ww^Bw/      , Ds          , Ds          , Gs^Fp       , Gg          , Gg          , Gg          , Gs^Fp       , Re          , Re          , Gg          , Gg          , Gg          , Ww          , Ww          , Ww          , Ww          , Ww          , Ww          , Ww          
Wo          , Ww          , Ww          , Ds          , Ds          , Gs^Fp       , Gs^Fp       , Gs^Fp       , Gs^Fp       , Re          , Gs^Fp       , Gg          , Gg          , Ds          , Gg          , Gg          , Gg          , Gg          , Ww          , Ww          , Ww          , Gg          
Wo          , Ww          , Ww^Bw/      , Ds          , Ds          , Gg          , Gg          , Gg          , Gg          , Re          , Gs^Fp       , Gg          , Gg          , Gg          , Gg          , Gg          , Ww          , Ww          , Gg          , Gg          , Gg          , Gg          
Wo          , Ww          , Ww          , Ds          , Ds          , Gg          , Gg          , Gg          , Re          , Re          , Gg          , Gg          , Gg          , Gg          , Ww          , Ww          , Gg          , Gg          , Gg          , Gg          , Gg          , Hh          
Wo          , Wo          , Ww          , Ww^Bw/      , Ds          , Gg          , Gg          , Gg          , Re          , Gg          , Gg          , Gg          , Gg          , Gg          , Ww          , Gg          , Gg          , Gg          , Gg          , Gg          , Gg          , Mm          
Wo          , Wo          , Wo          , Ww          , Ww          , Ds          , Gg          , Gg          , Re          , Gg          , Gg          , Gg          , Gg          , Gg          , Ww          , Gg          , Gg          , Gg          , Gg          , Gg          , Hh          , Mm          
Wo          , Wo          , Wo          , Wo          , Ww          , Ww          , Ww          , Gg          , Re          , Gg          , Ww          , Ww          , Ww          , Gg          , Ww          , Ww          , Gg^Vh       , Gg          , Gs^Fp       , Gg          , Hh          , Mm          
Wo          , Wo          , Wo          , Ww          , Ww^Bw\      , Ww          , Ww          , Ww          , Ww^Bw|      , Ww          , Gg          , Gg          , Ww          , Gg          , Ww          , Gg          , Gg          , Gg          , Gg          , Gg          , Mm          , Mm          
Wo          , Wo          , Ww          , Ww          , Ds          , Ds          , Gg          , Gg^Vh       , Re          , Gg          , Gg          , Gg          , Gg          , Ww          , Ww          , Gg          , Gg          , Gg          , Gg          , Gg          , Hh          , Mm          
Wo          , Wo          , Ww          , Ww^Bw\      , Ds          , Ds          , Gg          , Gg          , Re          , Gg          , Gg          , Gg          , Gs^Fp       , Gg          , Gs^Fp       , Gs^Fp       , Gg          , Gg          , Gg          , Gg          , Gg          , Hh          
Wo          , Ww          , Ww^Bw\      , Ds          , Ds          , Gs^Fp       , Gg          , Gg          , Re          , Gg          , Gg          , Gg          , Gs^Fp       , Gs^Fp       , Gs^Fp       , Gs^Fp       , Gg          , Gg          , Gg          , Gg          , Gg          , Gg          
Wo          , Wo          , Ww          , Ds          , Ds          , Gs^Fp       , Gg          , Gg          , Re          , Gg          , Hh          , Hh          , Gs^Fp       , Gs^Fp       , Gs^Fp       , Gg          , Gg          , Gg          , Gg          , Gg          , Gg          , Gg          
Wo          , Ww          , Ww          , Ds          , Gg          , Gg          , Gg          , Gg          , Gg          , Re          , Hh          , Hh          , Hh          , Gs^Fp       , Gg          , Gg          , Gg          , Gg          , Gg          , Gg          , Gg          , Gg          
Wo          , Ww          , Ww^Bw/      , Ds          , Ds          , Gg          , Gg          , Gg          , Gg          , Re          , Hh          , Hh          , Re          , Re          , Re          , Re          , Re          , Gg          , Gg          , Gs^Fp       , Gs^Fp       , Gs^Fp       
Ww          , Ww          , Ww          , Ds          , Ds          , Ds          , Gg          , Gg          , Gg          , Re          , Re          , Re          , Gg          , Gs^Fp       , Gg          , Gs^Fp       , Gs^Fp       , Re          , Re          , Gs^Fp       , Gg          , Gs^Fp       
Wo          , Wo          , Ww          , Ww^Bw/      , Ds          , Ds          , Gg          , Gg          , Gg          , Gg          , Hh          , Hh          , Hh          , Gg          , Gs^Fp       , Gs^Fp       , Gs^Fp       , Gs^Fp       , Gs^Fp       , Re          , Re          , Re          
Wo          , Wo          , Ww          , Ww          , Ds          , Ds          , Ds          , Gg          , Gg          , Gg          , Hh          , Hh          , Hh          , Gg          , Gs^Fp       , Gs^Fp       , Gg          , Gg          , Gs^Fp       , Gs^Fp       , Gs^Fp       , Gs^Fp       
Wo          , Wo          , Ww          , Ww^Bw/      , Ww          , Ds          , Ds          , Gg          , Gg          , Hh          , Gg          , Hh          , Gg          , Hh          , Gg          , Gg          , Gg          , Gg          , Gg          , Gg          , Gg          , Gg          
