border_size=1
usage=map

Y2          , Y2          , Y2          , Y2          , Y2          , Y2          , Y2          , Y2          , Y2          , Y2          , Y2          , Y2          , Y2          , Y2          , Y2          , Y2          , Y2          , Y2          , Y2          , Y2          , Y2          , Y2          
Y2          , Y2          , Y2          , Y2          , Y2          , Y2          , Y2          , Y2          , Xu          , Y2          , Y2          , Y2          , Y2          , Y2          , Y2          , Y2          , Y2          , Y2          , Y2          , Y2          , Y2          , Y2          
Y2          , Y2          , Y2          , Y2          , Xu          , Xu          , Xu          , Xu          , Xu          , Xu          , Xu          , Y2          , Y2          , Y2          , Y2          , Y2          , Y2          , Y2          , Y2          , Y2          , Y2          , Y2          
Y2          , Y2          , Y2          , Xu          , Xu          , Xu          , Xu          , Xu          , Xu          , Xu          , Xu          , Xu          , Xu          , Xu          , Xu          , Y2          , Y2          , Y2          , Y2          , Y2          , Y2          , Y2          
Y2          , Y2          , Y2          , Xu          , Xu          , Xu          , Y2          , Y2          , Y2          , Y2          , Y2          , Xu          , Xu          , Xu          , Xu          , Xu          , Xu          , Y2          , Y2          , Y2          , Y2          , Y2          
Y2          , Y2          , Y2          , Xu          , Xu          , Xu          , Y2          , Y2          , Y4          , Y2          , Y2          , Y2          , Xu          , Xu          , Xu          , Xu          , Xu          , Y2          , Y2          , Y2          , Y2          , Y2          
Y2          , Y2          , Xu          , Xu          , Xu          , Xu          , Y2          , Y4          , Y4          , Y4          , Y2          , Y2          , Xu          , Xu          , Xu          , Xu          , Xu          , Y2          , Y2          , Y2          , Y2          , Y2          
Y2          , Y2          , Xu          , Xu          , Xu          , Uu          , Y2          , Y4          , Y4          , Y4          , Y2          , Y2          , Xu          , Xu          , Xu          , Xu          , Xu          , Xu          , Y2          , Y2          , Y2          , Y2          
Y2          , Y2          , Xu          , Xu          , Xu          , Uu          , Y2          , Y2          , Y2          , Y2          , Uu          , Uu          , Uu          , Xu          , Uu          , Xu          , Xu          , Xu          , Xu          , Y2          , Y2          , Y2          
Y2          , Y2          , Y2          , Xu          , Xu          , Xu          , Xu          , Y2          , Xu          , Xu          , Xu          , Uu          , Xu          , Uu          , Uu          , Uu          , Xu          , Xu          , Xu          , Y2          , Y2          , Y2          
Y2          , Y2          , Y2          , Xu          , Xu          , Xu          , Xu          , Xu          , Xu          , Xu          , Xu          , Xu          , Xu          , Xu          , Uu          , Uu          , Xu          , Xu          , Xu          , Xu          , Y2          , Y2          
Y2          , Y2          , Y2          , Xu          , Xu          , Xu          , Xu          , Xu          , Xu          , Xu          , Xu          , Xu          , Xu          , Uu          , Uu          , Xu          , Xu          , Xu          , Xu          , Xu          , Y2          , Y2          
Y2          , Y2          , Y2          , Y2          , Xu          , Xu          , Xu          , Xu          , Xu          , Xu          , Xu          , Xu          , Xu          , Uu          , Uu          , Xu          , Xu          , Xu          , Xu          , Xu          , Y2          , Y2          
Y2          , Y2          , Y2          , Y2          , Y2          , Xu          , Xu          , Xu          , Xu          , Xu          , Xu          , Xu          , Xu          , Xu          , Uu          , Uu          , Xu          , Xu          , Xu          , Y2          , Y2          , Y2          
Y2          , Y2          , Y2          , Y2          , Y2          , Xu          , Xu          , Xu          , Xu          , Xu          , Xu          , Xu          , Xu          , Xu          , Y2          , Y2          , Xu          , Xu          , Xu          , Y2          , Y2          , Y2          
Y2          , Y2          , Y2          , Y2          , Xu          , Xu          , Xu          , Xu          , Xu          , Xu          , Xu          , Xu          , Y2          , Y2          , Y2          , Y2          , Xu          , Xu          , Xu          , Xu          , Y2          , Y2          
Y2          , Y2          , Y2          , Xu          , Xu          , Xu          , Xu          , Xu          , Y2          , Y2          , Y2          , Y2          , Xu          , Y2          , Y2          , Xu          , Xu          , Xu          , Xu          , Xu          , Y2          , Y2          
Y2          , Y2          , Y2          , Y2          , Xu          , Xu          , Xu          , Y2          , Y2          , Xu          , Xu          , Xu          , Xu          , Xu          , Xu          , Xu          , Xu          , Xu          , Y2          , Y2          , Y2          , Y2          
Y2          , Y2          , Y2          , Y2          , Y2          , Xu          , Y2          , Y2          , Y2          , Xu          , Xu          , Xu          , Xu          , Xu          , Xu          , Xu          , Y2          , Y2          , Y2          , Y2          , Y2          , Y2          
Y2          , Y2          , Y2          , Y2          , Y2          , Y2          , Y2          , Y2          , Y2          , Y2          , Y2          , Y2          , Y2          , Y2          , Y2          , Y2          , Y2          , Y2          , Y2          , Y2          , Y2          , Y2          
Y2          , Y2          , Y2          , Y2          , Y2          , Y2          , Y2          , Y2          , Y2          , Y2          , Y2          , Y2          , Y2          , Y2          , Y2          , Y2          , Y2          , Y2          , Y2          , Y2          , Y2          , Y2          
Y2          , Y2          , Y2          , Y2          , Y2          , Y2          , Y2          , Y2          , Y2          , Y2          , Y2          , Y2          , Y2          , Y2          , Y2          , Y2          , Y2          , Y2          , Y2          , Y2          , Y2          , Y2          
