border_size=1
usage=map

Xu          , Xu          , Xu          , Uu          , Uu          , Xu          , Xu          , Xu          , Xu          , Y2          , Y2          , Y2          , Y2          , Y2          , Y2          , Xu          , Xu          
Xu          , Xu          , Uu          , Uu          , Cud         , Uu          , Uu          , Xu          , Xu          , Xu          , Xu          , Y2          , Y2          , Y2          , Y2          , Xu          , Xu          
Xu          , Uu          , Uu          , Cud         , Kud         , Cud         , Uu          , Xu          , Xu          , Xu          , Xu          , Xu          , Y2          , Y2          , Y2          , Y2          , Y2          
Xu          , Uu          , Uu          , Cud         , Cud         , Cud         , Uu          , Uu          , Xu          , Xu          , Xu          , Xu          , Xu          , Y2          , Y2          , Y2          , Y2          
Xu          , Uu          , Uu          , Cud         , Uu          , Cud         , Uu          , Uu          , Xu          , Xu          , Xu          , Xu          , Xu          , Xu          , Y2          , Y2          , Y2          
Xu          , Uu          , Uu          , Uu          , Uu          , Uu          , Xu          , Xu          , Xu          , Xu          , Xu          , Xu          , Xu          , Xu          , Y2          , Y2          , Y2          
Xu          , Xu          , Xu          , Uu          , Y2          , Y2          , Y2          , Xu          , Xu          , Xu          , Xu          , Xu          , Xu          , Xu          , Xu          , Y2          , Xu          
Xu          , Xu          , Xu          , Xu          , Y2          , Y2          , Y2          , Y2          , Y2          , Xu          , Y2          , Xu          , Xu          , Xu          , Xu          , Xu          , Y2          
Xu          , Xu          , Xu          , Xu          , Xu          , Xu          , Xu          , Y2          , Xu          , Y2          , Y2          , Y2          , Y2          , Y2          , Y2          , Y2          , Y2          
Xu          , Xu          , Xu          , Xu          , Xu          , Xu          , Xu          , Xu          , Xu          , Xu          , Y2          , Y2          , Y2          , Y2          , Y2          , Y2          , Y2          
Xu          , Xu          , Xu          , Xu          , Xu          , Xu          , Xu          , Xu          , Xu          , Xu          , Y2          , Y2          , Y2          , Y2          , Y2          , Y2          , Y2          
Xu          , Xu          , Xu          , Xu          , Y2          , Xu          , Xu          , Xu          , Y2          , Y2          , Y2          , Y2          , Y2          , Y2          , Y2          , Y2          , Y2          
Xu          , Xu          , Y2          , Y2          , Y2          , Y2          , Y2          , Y2          , Y2          , Y2          , Y2          , Y2          , Y2          , Y2          , Y2          , Y2          , Y2          
Y2          , Y2          , Y2          , Y2          , Y2          , Y2          , Xu          , Y2          , Y2          , Y2          , Y2          , Y2          , Y2          , Y2          , Y2          , Y2          , Y2          
