border_size=1
usage=map

Qxu         ,Qxu         , Qxu         , Qxu         , Qxu         , Qxu         , Qxu         , Y2         , Cud         , Cud         , Cud         , Cud         , Cud         , Y2         , Qxu         , Qxu         , Qxu         , Qxu         , Qxu         , Qxu         , Qxu         
Qxu         ,Qxu         , Qxu         , Qxu         , Qxu         , Qxu         , Qxu         , Y2          , Cud         , Cud         , Kud         , Cud         , Cud         , Y2          , Qxu         , Qxu         , Qxu         , Qxu         , Qxu         , Qxu         , Qxu         
Qxu         ,Qxu         , Qxu         , Qxu         , Qxu         , Qxu         , Qxu         , Y2          , Cud         , Cud         , Cud         , Cud         , Cud         , Y2          , Qxu         , Qxu         , Qxu         , Qxu         , Qxu         , Qxu         , Qxu         
Qxu         ,Qxu         , Qxu         , Qxu         , Y2          , Qxu         , Qxu         , Y2          , Y2          , Cud         , Cud         , Cud         , Y2          , Y2          , Qxu         , Qxu         , Y2          , Qxu         , Qxu         , Qxu         , Qxu         
Qxu         ,Qxu         , Y2          , Y2          , Cud         , Y2          , Y2          , Qxu         , Qxu         , Y2          , Y2          , Y2          , Qxu         , Qxu         , Y2          , Y2          , Cud         , Y2          , Y2          , Qxu         , Qxu         
Qxu         ,Qxu         , Y2          , Cud         , Kud         , Cud         , Y2          , Qxu         , Qxu         , Qxu         , Y3   				, Qxu         , Qxu         , Qxu         , Y2          , Cud         , Kud         , Cud         , Y2          , Qxu         , Qxu         
Qxu         ,Qxu         , Y2          , Cud         , Cud         , Cud         , Y2          , Qxu         , Qxu         , Qxu         , Y2          , Qxu         , Qxu         , Qxu         , Y2          , Cud         , Cud         , Cud         , Y2          , Qxu         , Qxu         
Qxu         ,Qxu         , Qxu         , Y2          , Y2          , Y2          , Qxu         , Y2          , Y2          , Y2          , Cud         , Y2          , Y2          , Y2          , Qxu         , Y2          , Y2          , Y2          , Qxu         , Qxu         , Qxu         
Qxu         ,Qxu         , Qxu         , Qxu         , Y2          , Qxu         , Qxu         , Qxu         , Y2          , Cud         , Kud         , Cud         , Y2          , Qxu         , Qxu         , Qxu         , Y2          , Qxu         , Qxu         , Qxu         , Qxu         
Qxu         ,Qxu         , Qxu         , Qxu         , Y2          , Qxu         , Qxu         , Qxu         , Y2          , Cud         , Cud         , Cud         , Y2          , Qxu         , Qxu         , Qxu         , Y2          , Qxu         , Qxu         , Qxu         , Qxu         
Qxu         ,Qxu         , Y2          , Y2          , Cud         , Y2          , Y2          , Y2          , Qxu         , Y2          , Y2          , Y2          , Qxu         , Y2          , Y2          , Y2          , Cud         , Y2          , Y2          , Qxu         , Qxu         
Qxu         ,Qxu         , Y2          , Cud         , Kud         , Cud         , Y2          , Qxu         , Qxu         , Qxu         , Y2          , Qxu         , Qxu         , Qxu         , Y2          , Cud         , Kud         , Cud         , Y2          , Qxu         , Qxu         
Qxu         ,Qxu         , Y2          , Cud         , Cud         , Cud         , Y2          , Qxu         , Qxu         , Qxu         , Y2          , Qxu         , Qxu         , Qxu         , Y2          , Cud         , Cud         , Cud         , Y2          , Qxu         , Qxu         
Qxu         ,Qxu         , Qxu         , Y2          , Y2          , Y2          , Qxu         , Y2          , Y2          , Y2          , Cud         , Y2          , Y2          , Y2          , Qxu         , Y2          , Y2          , Y2          , Qxu         , Qxu         , Qxu         
Qxu         ,Qxu         , Qxu         , Qxu         , Y2          , Qxu         , Qxu         , Qxu         , Y2          , Cud         , Kud         , Cud         , Y2          , Qxu         , Qxu         , Qxu         , Y2          , Qxu         , Qxu         , Qxu         , Qxu         
Qxu         ,Qxu         , Qxu         , Qxu         , Y2          , Qxu         , Qxu         , Qxu         , Y2          , Cud         , Cud         , Cud         , Y2          , Qxu         , Qxu         , Qxu         , Y2          , Qxu         , Qxu         , Qxu         , Qxu         
Qxu         ,Qxu         , Y2          , Y2          , Cud         , Y2          , Y2          , Y2          , Qxu         , Y2          , Y2          , Y2          , Qxu         , Y2          , Y2          , Y2          , Cud         , Y2          , Y2          , Qxu         , Qxu         
Qxu         ,Qxu         , Y2          , Cud         , Kud         , Cud         , Y2          , Qxu         , Qxu         , Qxu         , Y3         	, Qxu         , Qxu         , Qxu         , Y2          , Cud         , Kud         , Cud         , Y2          , Qxu         , Qxu         
Qxu         ,Qxu         , Y2          , Cud         , Cud         , Cud         , Y2          , Qxu         , Qxu         , Qxu         , Y2         	, Qxu         , Qxu         , Qxu         , Y2          , Cud         , Cud         , Cud         , Y2          , Qxu         , Qxu         
Qxu         ,Qxu         , Qxu         , Y2          , Y2          , Y2          , Qxu         , Qxu         , Qxu         , Qxu         , Y2         	, Qxu         , Qxu         , Qxu         , Qxu         , Y2          , Y2          , Y2          , Qxu         , Qxu         , Qxu         
Qxu         ,Qxu         , Qxu         , Qxu         , Qxu         , Qxu         , Qxu         , Qxu         , Qxu         , Qxu         , Y2         	, Qxu         , Qxu         , Qxu         , Qxu         , Qxu         , Qxu         , Qxu         , Qxu         , Qxu         , Qxu         
Qxu         ,Qxu         , Qxu         , Qxu         , Qxu         , Qxu         , Qxu         , Qxu         , Qxu         , Qxu         , Y2        	, Qxu         , Qxu         , Qxu         , Qxu         , Qxu         , Qxu         , Qxu         , Qxu         , Qxu         , Qxu         
