border_size=1
usage=map

Wo          ,Wo          , Wo          , Wo          , Wo          , Wo          , Wo          , Wo          , Wo          , Wo          , Wo          , Wo          , Wo          , Wo          , Wo          , Wo          , Wo          
Wo          ,Wo          , Wo          , Wo          , Wo          , Wo          , Wo          , Wo          , Wo          , Wo          , Wo          , Wo          , Wo          , Wo          , Wo          , Wo          , Wo          
Wo          ,Wo          , Wo          , Wo          , Wo          , Wo          , Wo          , Wo          , Wo^Bw/      , Wo          , Wo          , Wo          , Wo          , Wo          , Wo          , Wo          , Wo          
Wo          ,Wo          , Wo          , Wo          , Wo          , Wo          , Wo^Bw/      , Wo^Bw/      , Wo          , Wo^Bw\      , Wo^Bw\      , Wo          , Wo          , Wo          , Wo          , Wo          , Wo          
Wo          ,Wo          , Wo          , Wo          , Wo^Bw/      , Wo^Bw/      , Wo          , Wo          , Wo          , Wo          , Wo          , Wo^Bw\      , Wo^Bw\      , Wo          , Wo          , Wo          , Wo          
Wo          ,Wo          , Wo^Bw/      , Wo^Bw/      , Wo          , Wo          , Wo          , Wo          , Wo^Bw\      , Wo          , Wo          , Wo          , Wo          , Wo^Bw\      , Wo^Bw\      , Wo          , Wo          
Wo          ,Wo          , Wo^Bw|      , Wo          , Wo          , Wo          , Wo^Bw/      , Wo^Bw/      , Wo          , Wo^Bw\      , Wo^Bw\      , Wo          , Wo          , Wo          , Wo^Bw|      , Wo          , Wo          
Wo          ,Wo          , Wo^Bw|      , Wo          , Wo          , Wo^Bw/      , Wo          , Wo          , Ch          , Wo          , Wo          , Wo^Bw\      , Wo          , Wo          , Wo^Bw|      , Wo          , Wo          
Wo          ,Wo          , Wo^Bw|      , Wo          , Wo          , Wo^Bw|      , Wo          , Ch          , Kh          , Ch          , Wo          , Wo^Bw|      , Wo          , Wo          , Wo^Bw|      , Wo          , Wo          
Wo          ,Wo          , Wo^Bw|      , Wo          , Wo          , Wo^Bw|      , Wo          , Ch          , Ch          , Ch          , Wo          , Wo^Bw|      , Wo          , Wo          , Wo^Bw|      , Wo          , Wo          
Wo          ,Wo          , Wo^Bw|      , Wo          , Wo          , Wo^Bw|      , Wo^Bw\      , Wo          , Wo          , Wo          , Wo^Bw/      , Wo^Bw|      , Wo          , Wo          , Wo^Bw|      , Wo          , Wo          
Wo          ,Wo          , Wo^Bw|      , Wo          , Wo          , Wo          , Wo          , Wo^Bw\      , Wo^Bw/      , Wo^Bw/      , Wo          , Wo          , Wo          , Wo          , Wo^Bw|      , Wo          , Wo          
Wo          ,Wo          , Wo          , Wo^Bw\      , Wo^Bw\      , Wo          , Wo          , Wo          , Wo          , Wo          , Wo          , Wo          , Wo^Bw/      , Wo^Bw/      , Wo          , Wo          , Wo          
Wo          ,Wo          , Wo          , Wo          , Wo          , Wo^Bw\      , Wo^Bw\      , Wo          , Wo          , Wo          , Wo^Bw/      , Wo^Bw/      , Wo          , Wo          , Wo          , Wo          , Wo          
Wo          ,Wo          , Wo          , Wo          , Wo          , Wo          , Wo          , Wo^Bw\      , Wo^Bw/      , Wo^Bw/      , Wo          , Wo          , Wo          , Wo          , Wo          , Wo          , Wo          
Wo          ,Wo          , Wo          , Wo          , Wo          , Wo          , Wo          , Wo          , Wo          , Wo          , Wo          , Wo          , Wo          , Wo          , Wo          , Wo          , Wo          
Wo          ,Wo          , Wo          , Wo          , Wo          , Wo          , Wo          , Wo          , Wo          , Wo          , Wo          , Wo          , Wo          , Wo          , Wo          , Wo          , Wo          
