border_size=1
usage=map

      Qxu,      Qxu,      Qxu,      Qxu,      Qxu,      Qxu,      Qxu,      Qxu,      Qxu,      Qxu,      Qxu,      Qxu,      Qxu,      Qxu,      Qxu,      Qxu,      Qxu,      Qxu,      Qxu,      Qxu,      Qxu,      Qxu,      Qxu,      Qxu,      Qxu,      Qxu,      Qxu,      Qxu,      Qxu,      Qxu,      Qxu,      Qxu,      Qxu,      Qxu,      Qxu,      Qxu,      Qxu,      Qxu,      Qxu,      Qxu,      Qxu,      Qxu
      Qxu,      Qxu,      Qxu,      Qxu,      Qxu,      Qxu,      Qxu,      Qxu,      Qxu,      Qxu,      Qxu,      Qxu,      Qxu,      Qxu,      Qxu,      Qxu,      Qxu,      Qxu,      Qxu,      Qxu,      Qxu,      Qxu,      Qxu,      Qxu,      Qxu,      Qxu,      Qxu,      Qxu,      Qxu,      Qxu,      Qxu,      Qxu,      Qxu,      Qxu,      Qxu,      Qxu,      Qxu,      Qxu,      Qxu,      Qxu,      Qxu,      Qxu
      Qxu,      Qxu,      Qxu,      Qxu,      Qxu,      Qxu,      Qxu,      Qxu,      Qxu,      Qxu,      Qxu,      Qxu,      Qxu,      Qxu,      Qxu,      Qxu,      Qxu,      Qxu,      Qxu,      Qxu,      Qxu,      Qxu,      Qxu,      Qxu,      Qxu,      Qxu,      Qxu,      Qxu,      Qxu,      Qxu,      Qxu,      Qxu,      Qxu,      Qxu,      Qxu,      Qxu,      Qxu,      Qxu,      Qxu,      Qxu,      Qxu,      Qxu
      Qxu,      Qxu,      Qxu,      Qxu,      Qxu,      Qxu,      Qxu,      Qxu,      Qxu,      Qxu,      Qxu,      Qxu,      Qxu,      Qxu,      Qxu,      Qxu,      Qxu,      Qxu,      Qxu,      Qxu,      Qxu,      Qxu,      Qxu,      Qxu,      Qxu,      Qxu,      Qxu,      Qxu,      Qxu,      Qxu,      Qxu,      Qxu,      Qxu,      Qxu,      Qxu,      Qxu,      Qxu,      Qxu,      Qxu,      Qxu,      Qxu,      Qxu
      Qxu,      Qxu,      Qxu,      Qxu,      Qxu,      Qxu,      Qxu,      Qxu,      Qxu,      Qxu,      Qxu,      Qxu,      Qxu,      Qxu,      Qxu,      Qxu,      Qxu,      Qxu,      Qxu,      Qxu,      Qxu,      Qxu,      Qxu,      Qxu,      Qxu,      Qxu,      Qxu,      Qxu,      Qxu,      Qxu,      Qxu,      Qxu,       Uu,       Uu,       Uu,      Qxu,      Qxu,      Qxu,      Qxu,      Qxu,      Qxu,      Qxu
      Qxu,      Qxu,      Qxu,      Qxu,      Qxu,      Qxu,      Qxu,      Qxu,      Qxu,      Qxu,      Qxu,      Qxu,      Qxu,      Qxu,      Qxu,      Qxu,      Qxu,      Qxu,      Qxu,      Qxu,      Qxu,      Qxu,      Qxu,      Qxu,      Qxu,      Qxu,      Qxu,      Qxu,      Qxu,      Qxu,       Uu,       Uu,      Cud,      Cud,      Cud,       Uu,       Uu,      Qxu,      Qxu,      Qxu,      Qxu,      Qxu
      Qxu,      Qxu,      Qxu,      Qxu,      Qxu,      Qxu,      Qxu,      Qxu,      Qxu,      Qxu,      Qxu,      Qxu,      Qxu,      Qxu,      Qxu,      Qxu,      Qxu,      Qxu,      Qxu,      Qxu,      Qxu,      Qxu,      Qxu,      Qxu,      Qxu,      Qxu,      Qxu,      Qxu,       Uu,       Uu,       Uu,       Uu,       Uu,      Cud,      Cud,      Cud,      Cud,       Uu,       Uu,      Qxu,      Qxu,      Qxu
      Qxu,      Qxu,      Qxu,      Qxu,      Qxu,      Qxu,      Qxu,      Qxu,      Qxu,      Qxu,      Qxu,      Qxu,      Qxu,      Qxu,      Qxu,      Qxu,      Qxu,      Qxu,      Qxu,      Qxu,      Qxu,      Qxu,      Qxu,      Qxu,      Qxu,      Qxu,      Qxu,      Qxu,      Qxu,       Uu,       Uu,       Uu,    Uu^Ii,       Uu,       Uu,      Cud,      Cud,      Cud,       Uu,       Uu,      Qxu,      Qxu
      Qxu,      Qxu,      Qxu,      Qxu,      Qxu,      Qxu,      Qxu,      Qxu,      Qxu,      Qxu,      Qxu,      Qxu,      Qxu,      Qxu,      Qxu,      Qxu,      Qxu,      Qxu,      Qxu,      Qxu,      Qxu,      Qxu,      Qxu,      Qxu,      Qxu,      Qxu,      Qxu,      Qxu,      Qxu,      Qxu,      Qxu,       Uu,       Uu,       Uu,       Uu,       Uu,       Uu,       Uu,      Qxu,      Qxu,      Qxu,      Qxu
      Qxu,      Qxu,      Qxu,      Qxu,      Qxu,      Qxu,      Qxu,      Qxu,      Qxu,      Qxu,      Qxu,      Qxu,      Qxu,      Qxu,      Qxu,      Qxu,      Qxu,      Qxu,      Qxu,      Qxu,      Qxu,      Qxu,      Qxu,      Qxu,      Qxu,      Qxu,      Qxu,      Qxu,      Qxu,      Qxu,      Qxu,      Qxu,      Qxu,       Uu,       Uu,       Uu,      Qxu,      Qxu,      Qxu,      Qxu,      Qxu,      Qxu
      Qxu,      Qxu,      Qxu,      Qxu,      Qxu,      Qxu,      Qxu,      Qxu,      Qxu,      Qxu,      Qxu,      Qxu,      Qxu,      Qxu,      Qxu,      Qxu,      Qxu,      Qxu,      Qxu,      Qxu,      Qxu,      Qxu,      Qxu,      Qxu,      Qxu,      Qxu,      Qxu,      Qxu,      Qxu,      Qxu,      Qxu,      Qxu,      Qxu,      Qxu,      Qxu,      Qxu,      Qxu,      Qxu,      Qxu,      Qxu,      Qxu,      Qxu
      Qxu,      Qxu,      Qxu,      Qxu,      Qxu,      Qxu,      Qxu,      Qxu,      Qxu,      Qxu,      Qxu,      Qxu,      Qxu,      Qxu,      Qxu,      Qxu,      Qxu,      Qxu,      Qxu,      Qxu,      Qxu,      Qxu,      Qxu,      Qxu,      Qxu,      Qxu,      Qxu,      Qxu,      Qxu,      Qxu,      Qxu,      Qxu,      Qxu,      Qxu,      Qxu,      Qxu,      Qxu,      Qxu,      Qxu,      Qxu,      Qxu,      Qxu
      Qxu,      Qxu,      Qxu,      Qxu,      Qxu,      Qxu,      Qxu,      Qxu,      Qxu,      Qxu,      Qxu,      Qxu,      Qxu,      Qxu,      Qxu,      Qxu,       Uu,       Kud,       Uu,      Qxu,      Qxu,      Qxu,      Qxu,      Qxu,      Qxu,      Qxu,      Qxu,      Qxu,      Qxu,      Qxu,      Qxu,      Qxu,      Qxu,      Qxu,      Qxu,      Qxu,      Qxu,      Qxu,      Qxu,      Qxu,      Qxu,      Qxu
      Qxu,      Qxu,      Qxu,      Qxu,      Qxu,      Qxu,      Qxu,      Qxu,      Qxu,      Qxu,      Qxu,      Qxu,      Qxu,      Qxu,       Uu,       Uu,      Cud,      Cud,      Cud,       Uu,       Uu,      Qxu,      Qxu,      Qxu,      Qxu,      Qxu,      Qxu,      Qxu,      Qxu,      Qxu,      Qxu,      Qxu,      Qxu,      Qxu,      Qxu,      Qxu,      Qxu,      Qxu,      Qxu,      Qxu,      Qxu,      Qxu
      Qxu,      Qxu,      Qxu,      Qxu,      Qxu,      Qxu,      Qxu,      Qxu,      Qxu,      Qxu,      Qxu,      Qxu,      Qxu,       Uu,       Uu,      Cud,      Cud,      Cud,      Cud,      Cud,       Uu,       Uu,      Qxu,      Qxu,      Qxu,      Qxu,      Qxu,      Qxu,      Qxu,      Qxu,      Qxu,      Qxu,      Qxu,      Qxu,      Qxu,      Qxu,      Qxu,      Qxu,      Qxu,      Qxu,      Qxu,      Qxu
      Qxu,      Qxu,      Qxu,      Qxu,      Qxu,      Qxu,      Qxu,      Qxu,      Qxu,      Qxu,       Uu,       Kud,       Uu,      Qxu,      Qxu,       Uu,       Uu,      Cud,       Uu,       Uu,      Qxu,      Qxu,       Uu,       Kud,       Uu,      Qxu,      Qxu,      Qxu,      Qxu,      Qxu,      Qxu,      Qxu,      Qxu,      Qxu,      Qxu,      Qxu,      Qxu,      Qxu,      Qxu,      Qxu,      Qxu,      Qxu
      Qxu,      Qxu,      Qxu,      Qxu,      Qxu,      Qxu,      Qxu,      Qxu,       Uu,       Uu,      Cud,      Cud,      Cud,       Uu,       Uu,      Qxu,      Qxu,       Uu,      Qxu,      Qxu,       Uu,       Uu,      Cud,      Cud,      Cud,       Uu,       Uu,      Qxu,      Qxu,      Qxu,      Qxu,      Qxu,      Qxu,      Qxu,      Qxu,      Qxu,      Qxu,      Qxu,      Qxu,      Qxu,      Qxu,      Qxu
      Qxu,      Qxu,      Qxu,      Qxu,      Qxu,      Qxu,      Qxu,       Uu,       Uu,      Cud,      Cud,      Cud,      Cud,      Cud,       Uu,       Uu,      Qxu,      Qxu,      Qxu,       Uu,       Uu,      Cud,      Cud,      Cud,      Cud,      Cud,       Uu,       Uu,      Qxu,      Qxu,      Qxu,      Qxu,      Qxu,      Qxu,      Qxu,      Qxu,      Qxu,      Qxu,      Qxu,      Qxu,      Qxu,      Qxu
      Qxu,      Qxu,      Qxu,      Qxu,       Uu,       Kud,       Uu,      Qxu,      Qxu,       Uu,       Uu,      Cud,       Uu,       Uu,      Qxu,      Qxu,       Uu,       Kud,       Uu,      Qxu,      Qxu,       Uu,       Uu,      Cud,       Uu,       Uu,      Qxu,      Qxu,       Uu,       Kud,       Uu,      Qxu,      Qxu,      Qxu,      Qxu,      Qxu,      Qxu,      Qxu,      Qxu,      Qxu,      Qxu,      Qxu
      Qxu,      Qxu,       Uu,       Uu,      Cud,      Cud,      Cud,       Uu,       Uu,      Qxu,      Qxu,       Uu,      Qxu,      Qxu,       Uu,       Uu,      Cud,      Cud,      Cud,       Uu,       Uu,      Qxu,      Qxu,       Uu,      Qxu,      Qxu,       Uu,       Uu,      Cud,      Cud,      Cud,       Uu,       Uu,      Qxu,      Qxu,      Qxu,      Qxu,      Qxu,      Qxu,      Qxu,      Qxu,      Qxu
    Uu,    Uu^Vu,       Uu,      Cud,      Cud,      Cud,      Cud,      Cud,       Uu,       Uu,      Qxu,      Qxu,      Qxu,       Uu,       Uu,      Cud,      Cud,      Cud,      Cud,      Cud,       Uu,       Uu,      Qxu,      Qxu,      Qxu,       Uu,       Uu,      Cud,      Cud,      Cud,      Cud,      Cud,       Uu,       Uu,      Qxu,      Qxu,      Qxu,      Qxu,      Qxu,      Qxu,      Qxu,      Qxu
      Qxu,      Qxu,      Qxu,       Uu,       Uu,      Cud,       Uu,       Uu,      Qxu,      Qxu,       Uu,       Kud,       Uu,      Qxu,      Qxu,       Uu,       Uu,      Cud,       Uu,       Uu,      Qxu,      Qxu,       Uu,       Kud,       Uu,      Qxu,      Qxu,       Uu,       Uu,      Cud,       Uu,       Uu,      Qxu,      Qxu,      Qxu,      Qxu,      Qxu,      Qxu,      Qxu,      Qxu,      Qxu,      Qxu
      Qxu,      Qxu,      Qxu,      Qxu,      Qxu,       Uu,      Qxu,      Qxu,       Uu,       Uu,      Cud,      Cud,      Cud,       Uu,       Uu,      Qxu,      Qxu,       Uu,      Qxu,      Qxu,       Uu,       Uu,      Cud,      Cud,      Cud,       Uu,       Uu,      Qxu,      Qxu,       Uu,      Qxu,      Qxu,      Qxu,      Qxu,      Qxu,      Qxu,      Qxu,      Qxu,      Qxu,      Qxu,      Qxu,      Qxu
      Qxu,      Qxu,      Qxu,      Qxu,      Qxu,      Qxu,      Qxu,       Uu,       Uu,      Cud,      Cud,      Cud,      Cud,      Cud,       Uu,       Uu,      Qxu,      Qxu,      Qxu,       Uu,       Uu,      Cud,      Cud,      Cud,      Cud,      Cud,       Uu,       Uu,      Qxu,      Qxu,      Qxu,      Qxu,      Qxu,      Qxu,      Qxu,      Qxu,      Qxu,      Qxu,      Qxu,      Qxu,      Qxu,      Qxu
      Qxu,      Qxu,      Qxu,      Qxu,      Qxu,      Qxu,      Qxu,      Qxu,      Qxu,       Uu,       Uu,      Cud,       Uu,       Uu,      Qxu,      Qxu,       Uu,       Kud,       Uu,      Qxu,      Qxu,       Uu,       Uu,      Cud,       Uu,       Uu,      Qxu,      Qxu,      Qxu,      Qxu,      Qxu,      Qxu,      Qxu,      Qxu,      Qxu,      Qxu,      Qxu,      Qxu,      Qxu,      Qxu,      Qxu,      Qxu
      Qxu,      Qxu,      Qxu,      Qxu,      Qxu,      Qxu,      Qxu,      Qxu,      Qxu,      Qxu,      Qxu,       Uu,      Qxu,      Qxu,       Uu,       Uu,      Cud,      Cud,      Cud,       Uu,       Uu,      Qxu,      Qxu,       Uu,      Qxu,      Qxu,      Qxu,      Qxu,      Qxu,      Qxu,      Qxu,      Qxu,      Qxu,      Qxu,      Qxu,      Qxu,      Qxu,      Qxu,      Qxu,      Qxu,      Qxu,      Qxu
      Qxu,      Qxu,      Qxu,      Qxu,      Qxu,      Qxu,      Qxu,      Qxu,      Qxu,      Qxu,      Qxu,      Qxu,      Qxu,       Uu,       Uu,      Cud,      Cud,      Cud,      Cud,      Cud,       Uu,       Uu,      Qxu,      Qxu,      Qxu,      Qxu,      Qxu,      Qxu,      Qxu,      Qxu,      Qxu,      Qxu,      Qxu,      Qxu,      Qxu,      Qxu,      Qxu,      Qxu,      Qxu,      Qxu,      Qxu,      Qxu
      Qxu,      Qxu,      Qxu,      Qxu,      Qxu,      Qxu,      Qxu,      Qxu,      Qxu,      Qxu,      Qxu,      Qxu,      Qxu,      Qxu,      Qxu,       Uu,       Uu,      Cud,       Uu,       Uu,      Qxu,      Qxu,      Qxu,      Qxu,       Uu,      Qxu,      Qxu,      Qxu,      Qxu,      Qxu,      Qxu,      Qxu,      Qxu,      Qxu,      Qxu,      Qxu,      Qxu,      Qxu,      Qxu,      Qxu,      Qxu,      Qxu
      Qxu,      Qxu,      Qxu,      Qxu,      Qxu,      Qxu,      Qxu,      Qxu,      Qxu,      Qxu,      Qxu,      Qxu,      Qxu,      Qxu,      Qxu,      Qxu,      Qxu,       Uu,      Qxu,      Qxu,      Qxu,      Qxu,       Uu,      Qxu,      Qxu,      Qxu,       Uu,      Qxu,      Qxu,      Qxu,      Qxu,      Qxu,      Qxu,      Qxu,      Qxu,      Qxu,      Qxu,      Qxu,      Qxu,      Qxu,      Qxu,      Qxu
      Qxu,      Qxu,      Qxu,      Qxu,      Qxu,      Qxu,      Qxu,      Qxu,      Qxu,      Qxu,      Qxu,      Qxu,      Qxu,      Qxu,      Qxu,      Qxu,      Qxu,      Qxu,      Qxu,      Qxu,       Uu,      Qxu,      Qxu,      Qxu,       Uu,      Qxu,      Qxu,      Qxu,       Uu,      Qxu,      Qxu,      Qxu,      Qxu,      Qxu,      Qxu,      Qxu,      Qxu,      Qxu,      Qxu,      Qxu,      Qxu,      Qxu
      Qxu,      Qxu,      Qxu,      Qxu,      Qxu,      Qxu,      Qxu,      Qxu,      Qxu,      Qxu,      Qxu,      Qxu,      Qxu,      Qxu,      Qxu,      Qxu,      Qxu,      Qxu,      Qxu,      Qxu,      Qxu,      Qxu,       Uu,      Qxu,      Qxu,      Qxu,       Uu,      Qxu,      Qxu,      Qxu,      Qxu,      Qxu,      Qxu,      Qxu,      Qxu,      Qxu,      Qxu,      Qxu,      Qxu,      Qxu,      Qxu,      Qxu
      Qxu,      Qxu,      Qxu,      Qxu,      Qxu,      Qxu,      Qxu,      Qxu,      Qxu,      Qxu,      Qxu,      Qxu,      Qxu,      Qxu,      Qxu,      Qxu,      Qxu,      Qxu,      Qxu,      Qxu,      Qxu,      Qxu,      Qxu,      Qxu,       Uu,      Qxu,      Qxu,      Qxu,      Qxu,      Qxu,      Qxu,      Qxu,      Qxu,      Qxu,      Qxu,      Qxu,      Qxu,      Qxu,      Qxu,      Qxu,      Qxu,      Qxu
      Qxu,      Qxu,      Qxu,      Qxu,      Qxu,      Qxu,      Qxu,      Qxu,      Qxu,      Qxu,      Qxu,      Qxu,      Qxu,      Qxu,      Qxu,      Qxu,      Qxu,      Qxu,      Qxu,      Qxu,      Qxu,      Qxu,      Qxu,      Qxu,      Qxu,      Qxu,      Qxu,      Qxu,       Uu,       Uu,       Uu,      Qxu,       Uu,      Qxu,      Qxu,      Qxu,      Qxu,      Qxu,      Qxu,      Qxu,      Qxu,      Qxu
      Qxu,      Qxu,      Qxu,      Qxu,      Qxu,      Qxu,      Qxu,      Qxu,      Qxu,      Qxu,      Qxu,      Qxu,      Qxu,      Qxu,      Qxu,      Qxu,      Qxu,      Qxu,      Qxu,      Qxu,      Qxu,      Qxu,      Qxu,      Qxu,      Qxu,      Qxu,      Qxu,       Uu,       Uu,       Uu,      Qxu,       Uu,       Uu,       Uu,       Uu,      Qxu,      Qxu,      Qxu,      Qxu,      Qxu,      Qxu,      Qxu
      Qxu,      Qxu,      Qxu,      Qxu,      Qxu,      Qxu,      Qxu,      Qxu,      Qxu,      Qxu,      Qxu,      Qxu,      Qxu,      Qxu,      Qxu,      Qxu,      Qxu,      Qxu,      Qxu,      Qxu,      Qxu,      Qxu,      Qxu,      Qxu,      Qxu,      Qxu,      Qxu,      Qxu,       Uu,       Uu,       Uu,      Qxu,       Uu,       Uu,       Uu,      Qxu,      Qxu,      Qxu,      Qxu,      Qxu,      Qxu,      Qxu
      Qxu,      Qxu,      Qxu,      Qxu,      Qxu,      Qxu,      Qxu,      Qxu,      Qxu,      Qxu,      Qxu,      Qxu,      Qxu,      Qxu,      Qxu,      Qxu,      Qxu,      Qxu,      Qxu,      Qxu,      Qxu,      Qxu,      Qxu,      Qxu,      Qxu,      Qxu,      Qxu,      Qxu,      Qxu,       Uu,       Uu,       Uu,       Uu,       Uu,       Uu,       Uu,      Qxu,      Qxu,      Qxu,      Qxu,      Qxu,      Qxu
      Qxu,      Qxu,      Qxu,      Qxu,      Qxu,      Qxu,      Qxu,      Qxu,      Qxu,      Qxu,      Qxu,      Qxu,      Qxu,      Qxu,      Qxu,      Qxu,      Qxu,      Qxu,      Qxu,      Qxu,      Qxu,      Qxu,      Qxu,      Qxu,      Qxu,      Qxu,      Qxu,      Qxu,      Qxu,      Qxu,      Qxu,      Qxu,      Qxu,       Uu,      Qxu,      Qxu,      Qxu,      Qxu,      Qxu,      Qxu,      Qxu,      Qxu
      Qxu,      Qxu,      Qxu,      Qxu,      Qxu,      Qxu,      Qxu,      Qxu,      Qxu,      Qxu,      Qxu,      Qxu,      Qxu,      Qxu,      Qxu,      Qxu,      Qxu,      Qxu,      Qxu,      Qxu,      Qxu,      Qxu,      Qxu,      Qxu,      Qxu,      Qxu,      Qxu,      Qxu,      Qxu,      Qxu,      Qxu,      Qxu,      Qxu,      Qxu,      Qxu,      Qxu,      Qxu,       Uu,       Uu,      Qxu,      Qxu,      Qxu
      Qxu,      Qxu,      Qxu,      Qxu,      Qxu,      Qxu,      Qxu,      Qxu,      Qxu,      Qxu,      Qxu,      Qxu,      Qxu,      Qxu,      Qxu,      Qxu,      Qxu,      Qxu,      Qxu,      Qxu,      Qxu,      Qxu,      Qxu,      Qxu,      Qxu,      Qxu,      Qxu,      Qxu,      Qxu,      Qxu,      Qxu,      Qxu,      Qxu,      Qxu,      Qxu,      Qxu,      Qxu,      Qxu,      Qxu,       Uu,       Uu,       Uu
      Qxu,      Qxu,      Qxu,      Qxu,      Qxu,      Qxu,      Qxu,      Qxu,      Qxu,      Qxu,      Qxu,      Qxu,      Qxu,      Qxu,      Qxu,      Qxu,      Qxu,      Qxu,      Qxu,      Qxu,      Qxu,      Qxu,      Qxu,      Qxu,      Qxu,      Qxu,      Qxu,      Qxu,      Qxu,      Qxu,      Qxu,      Qxu,      Qxu,      Qxu,      Qxu,      Qxu,      Qxu,      Qxu,      Qxu,      Qxu,      Qxu,      Qxu
      Qxu,      Qxu,      Qxu,      Qxu,      Qxu,      Qxu,      Qxu,      Qxu,      Qxu,      Qxu,      Qxu,      Qxu,      Qxu,      Qxu,      Qxu,      Qxu,      Qxu,      Qxu,      Qxu,      Qxu,      Qxu,      Qxu,      Qxu,      Qxu,      Qxu,      Qxu,      Qxu,      Qxu,      Qxu,      Qxu,      Qxu,      Qxu,      Qxu,      Qxu,      Qxu,      Qxu,      Qxu,      Qxu,      Qxu,      Qxu,      Qxu,      Qxu
      Qxu,      Qxu,      Qxu,      Qxu,      Qxu,      Qxu,      Qxu,      Qxu,      Qxu,      Qxu,      Qxu,      Qxu,      Qxu,      Qxu,      Qxu,      Qxu,      Qxu,      Qxu,      Qxu,      Qxu,      Qxu,      Qxu,      Qxu,      Qxu,      Qxu,      Qxu,      Qxu,      Qxu,      Qxu,      Qxu,      Qxu,      Qxu,      Qxu,      Qxu,      Qxu,      Qxu,      Qxu,      Qxu,      Qxu,      Qxu,      Qxu,      Qxu
